┌───┬───┬───┬───┬───┬─┐
│   │   │   │   │   │F│
│ │ │ │ │ │ │ │ │ │ │ │
│ │ │ │ │ │ │ │ │ │ │ │
│ │ │ │ │ │ │ │ │ │ │ │
│ │ │ │ │ │ │ │ │ │ │ │
│ │ │ │ │ │ │ │ │ │ │ │
│ │   │   │   │   │   │
└─┴───┴───┴───┴───┴───┘