┌─┬───────┐
│ │       │
│   ┌─ │  │
├───┘  │  │
│     ┌┴──┘
│ ┌───┘  F
│ │     ┌─┐
│   ────┘L│
│         │
└─────────┘